1,1,1,1,1,1,1,1,1,1,1,1,1,1,1,1,1,1,1
1,9,0,0,0,0,0,0,0,0,0,0,0,0,0,0,0,2,1
1,0,0,2,0,0,0,2,0,0,0,3,0,0,0,2,0,0,1
1,0,0,1,0,0,0,1,0,0,0,1,0,0,0,1,0,0,1
1,2,0,0,0,2,0,0,0,2,0,0,0,2,0,0,0,2,1
1,1,0,0,0,1,0,0,0,1,0,0,0,1,0,0,0,1,1
1,2,0,0,0,0,0,2,0,0,0,0,0,0,0,0,0,0,1
1,0,0,0,1,1,1,1,0,0,0,1,1,1,1,1,0,0,1
1,8,7,0,0,0,0,0,0,0,0,1,6,0,0,0,0,0,1
1,1,1,1,1,1,1,1,1,1,1,1,1,1,1,1,1,1,1
Level 1